[{XXXXXXX0XXXXXXX},
{X0000000X00000X},
{X0XXXXXXXXXXX0X},
{X000X00000X000X},
{X0X0X0XXX0X0X0X},
{X0X000X0X0X0X0X},
{X0XXXXX0X000X0X},
{X0X000X0X0X0X0X},
{X0X0X0X0XXX0X0X},
{X0X0X000X000X0X},
{X0X0XXXXXXXXX0X},
{X0X000X0000000X},
{X0XXX0XXXXX0XXX},
{X00000X0000000X},
{XXXXXXX0XXXXXXX}
]